{
  "丑": "醜",
  "专": "專",
  "业": "業",
  "丟": "丢",
  "为": "為",
  "么": "麼",
  "习": "習",
  "乡": "鄉",
  "买": "買",
  "乱": "亂",
  "亏": "虧",
  "仑": "侖",
  "伫": "佇",
  "体": "體",
  "何": "曷",
  "備": "备",
  "关": "關",
  "决": "決",
  "划": "劃",
  "务": "務",
  "卢": "盧",
  "卫": "衛",
  "厂": "廠",
  "县": "県",
  "发": "發",
  "变": "變",
  "台": "檯",
  "叶": "葉",
  "吂": "汒",
  "后": "後",
  "呂": "吕",
  "坚": "堅",
  "夅": "降",
  "实": "實",
  "尧": "堯",
  "尽": "儘",
  "巷": "衖",
  "应": "應",
  "彐": "彑",
  "当": "噹",
  "忄": "心",
  "慍": "愠",
  "戋": "戔",
  "戲": "戏",
  "择": "擇",
  "术": "朮",
  "杂": "雜",
  "条": "條",
  "杰": "傑",
  "棄": "弃",
  "欢": "歡",
  "犾": "斦",
  "皃": "貌",
  "盐": "鹽",
  "监": "監",
  "称": "稱",
  "穀": "谷",
  "穷": "窮",
  "粦": "磷",
  "罴": "羆",
  "荊": "荆",
  "获": "獲",
  "萨": "薩",
  "虽": "雖",
  "覺": "觉",
  "讠": "言",
  "豈": "岂",
  "贲": "賁",
  "赂": "賂",
  "赵": "趙",
  "辭": "辞",
  "这": "這",
  "還": "还",
  "釁": "衅",
  "鍁": "锨",
  "陝": "陕",
  "靈": "灵",
  "饣": "食",
  "齐": "齊"
}